7 64
0 0 0 0 0 0 0 0 0 0 0 0 0 0 0 0 0 0 0 0 0 0 0 0 0 0 0 0 0 0 0 0 0 0 0 0 0 0 0 0 0 0 0 0 0 0 0 0 0 0 0 0 0 0 0 0 0 0 0 0 0 0 0 0
1 2 3 2 4 5 3 3 3 3 3 3 3 3 3 3 3 3 3 3 3 3 2 4 5 3 3 3 3 3 2 3 3 2 3 3 3 3 3 3 3 3 3 3 3 3 3 3 3 3 3 3 3 3 3 3 3 3 3 3 3 3 3 3
6 7 8 9 10 11 12 12 13 14 15 16 17 16 18 19 12 12 18 19 12 12 7 10 11 18 19 12 18 19 7 8 20 9 8 21 12 18 19 12 12 18 19 12 12 12 22 23 12 12 24 17 16 25 24 26 14 16 12 27 12 12 18 19
28 29 30 31 31 32 27 33 34 35 36 37 35 37 38 12 12 39 17 16 40 12 29 31 32 12 22 41 41 23 29 30 30 31 30 32 27 12 42 12 22 41 23 27 12 42 43 44 18 45 34 35 37 46 47 36 35 37 38 18 48 17 40 16
49 50 51 52 52 53 50 54 55 55 55 56 55 56 55 57 53 58 59 60 61 62 50 52 53 42 43 63 63 44 50 51 51 52 51 53 50 53 64 65 43 63 44 65 42 64 43 44 50 54 55 55 56 55 56 55 55 56 55 53 58 59 61 60
66 67 67 67 67 67 67 67 67 67 67 67 67 67 67 67 68 69 70 69 70 69 70 69 70 64 43 63 63 44 69 69 71 72 69 73 67 67 74 67 75 76 77 68 64 64 43 44 69 69 78 69 78 69 78 69 73 67 67 67 67 67 67 67
79 80 80 80 80 80 80 80 80 80 80 80 80 80 80 80 81 69 82 69 82 69 82 69 82 82 83 84 84 85 69 69 83 82 69 86 80 80 80 80 80 80 80 81 82 82 83 85 69 69 87 69 87 69 87 69 86 80 80 80 80 80 80 80
52
0 0 176 16 136 0
0 16 40 528 40 0
0 576 40 32 8 0
0 640 40 32 8 0
0 704 40 32 8 0
0 768 40 32 8 0
0 800 72 32 8 0
0 832 104 128 8 0
0 1024 40 64 8 0
0 1120 40 288 40 0
0 1216 104 32 8 0
0 1280 104 96 8 0
0 1408 72 32 8 0
0 1440 104 32 8 0
0 1472 136 64 8 0
0 1600 40 16 8 0
0 1664 40 16 8 0
0 1728 40 16 8 0
0 1792 40 240 40 0
1 240 72 32 32 1
1 288 72 32 32 1
1 336 72 32 32 1
1 432 72 32 32 1
1 1280 136 32 32 1
1 1440 136 32 32 1
1 1472 168 32 32 1
1 1872 72 32 32 1
1 1952 72 32 32 1
2 224 56 24 16 0
2 936 120 24 16 0
2 896 120 24 16 1
2 1272 56 24 16 1
3 800 104 32 32 1
3 1200 136 32 32 1
4 552 160 16 32 1
4 712 160 16 32 1
4 1720 160 24 32 1
4 1864 160 24 32 1
4 1048 144 24 32 0
4 1560 144 24 32 0
5 1368 72 16 32 1
7 800 72 32 32 1
9 328 88 16 16 1 
9 424 88 16 16 1  
10 568 88 16 16 1  
13 632 104 16 16 1 
15 760 120 16 16 1 
12 888 152 16 16 1 
10 1144 88 16 16 1  
17 1176 152 16 16 1  
10 1320 152 16 16 1  
14 1656 88 16 16 1  
11 1848 88 16 16 1 
